p p p p p v v v v p p p p p p p p p b b b p p p p p p p p p p p p p p p p p p p p p p p p p p p b b b b b p b
p p p p p b b b b p p p p p p p p p p p p p p p p p p v v v v v v v v p p p p p p p p p b b b b b b b b b b b
p p p p p v v v v p p p p p p p p p b b b p p p p p p p p p p p p p p p p p p p p p p p p p p p b b b b b p b
p p p p p b b b b p p p p p p p p p p p p p p p p p p v v v v v v v v p p p p p p p p p b b b b b b b b b b b
p p p p p v v v v p p p p p p v v v b b b p p p p p p p p p p p p p p p p p p v v p p p p p p p b b b b b p b
p p p p p b b b b p p p p p p p p p p p p p p p p b b v v v v v v v v p p p p p p p p p b b b b b b b b b b b
p p p p p v v v v p p p p p b v v v b b b v v v v v v p p p p b b b b b b b b v v p p p p p p p b b b b b p b
p p p p p b b b b v v v v v v b b b p p p p p p p b b v v v v v v v v p p p p p p p p p b b b b p p p p p b b
p b b b b p p p p p p p v v b v v v b b b v v v v v v p p p p b b b b b b b b v v v v b v v v v b b b b b p b
p p p p p b b b b v v v v v v b b b p p p p p p p b b v v v v v v v v p p p p p p v v p b b b b p p p p p b b
p b b b b p p p p p p p v v b v v v b b b v v v v v v p p p p b b b b b b b b v v v v b v v v v b b b b b p b
p p p p p b b b b v v v v v v b b b p p p p p p p b b v v v v v v v v p p p p p p v v p b b b b p p p p p b b
p b b b b p p p p p p p v v b v v v b b b v v v v v v p p p p b b b b b b b b v v v v b v v v v b b b b b p b
p p p p p b b b b v v v v v v b b b p p p p p p p b b v v v v v v v v p p p p p p v v p b b b b p p p p p b b
p b b b b p p p p p p p v v b v v v b b b v v v v v v p p p p b b b b b b b b v v v v b v v v v b b b b b p b
p p p p p b b b b v v v v v v b b b p p p p p p p b b v v v v v v v v p p p p p p v v p b b b b p p p p p b b
p b b b b p p p p p p p v v b v v v b b b v v v v v v p p p p b b b b b b b b v v v v b v v v v b b b b b p b
p p p p p b b b b v v v v v v b b b p p p p p p p b b v v v v v v v v p p p p p p v v p b b b b p p p p p b b
p b b b b p p p p p p p v v b v v v b b b v v v v v v p p p p b b b b b b b b v v v v b v v v v b b b b b p b
p p p p p v v v v v v v v v v b b b p p p p p p p v v v v v v v v v v p p p p p p v v p b b b b p p p p p b b
p b b b b p p p p p p p v v b v v v b b b v v v v v v b b b b b b b b b b b b v v v v b v v v v b b b b b p b
p p p p p v v v v v v v v v v b b b v v v v v v v v v v v v v v v v v p p p p p p v v p b b b b p p p p p b b
p p p p p p p p p p p p b b b v v v b b b v v v v v v b b b b b b b b b b b b b b b b b v v v v b b b b b b b
p p p p p b b b b b b b b b b b b b v v v b b b b b b v v v v v v v v p p p p p p b b p b b b b p b b b b b b
p p p p p p p p p p p p b b b v v v b b b b b b b b b b b b b b b b b b b b b b b b b b v v v v b b b b b b b
p p p p p b b b b b b b b b b b b b b b b b b b b b b v v v v v v v v b b b b b b b b p b b b b p b b b b b b
p p p p p b b b b b b b b b b v v v b b b b b b b b b b b b b b b b b b b b b b b b b b v v v v b b b b b b b
p p p p p b b b b b b b b b b b b b b b b b b b b b b b b b b b b b b b b b b b b b b b b b b b p b b b b b b
